mindful: để ý
indicate: chỉ ra
enthusiastic: nhiệt tình, hăng hái
primary: cơ bản, chủ yếu
informative: đầy đủ thông tin, hữu ích
terminal: nhà ga
icy: đóng băng
supplement: phần bổ sung
renovation: cải tạo
ease: làm giảm
congestion: sự tắc nghẽn
accommodation: chỗ ở, nhà trọ
shuttle bus: xe đưa đón
compliment: khen
complimentary: miễn phí
realtor: môi giới bất động sản
custodial: chăm sóc
bid : sự báo giá
revision: sự sửa lại
whether: liệu rằng
obtain: đạt được, thu được
absorbent: thấm hút
compete: cạnh tranh
claim: tuyên bố, khẳng định
inquire: hỏi thông tin, tìm hiểu
relate: đồng cảm
regardless of: bất kể, dù cho
surplus: số dư, thừa
rear: sau
list price: giá niêm yết
entrance: lối vào
assemble: lắp ráp, thu thập
furthermor: hơn nữa
furnished: nội thất
firm: hãng
superficially: hời hợt
magnificently: tráng lệ
unanimously: nhất trí
clerk: nhân viên
considering: xét về
as if: như thể
beyond: vượt ra ngoài
accomplish: hoàn thành - accomplished: giỏi, tài năng
in charge of: chịu trách nhiệm
narrating: tóm tắt lại
resuming: khôi phục